#########################
###                  #  #
#  #            #   #   #
#  #            #       #
#   ###         #       #
#   #  #        ###     #
#   #       #########   #
#   #             ###   #
#  #              #     #
# #    #           #    #
#       #           #   #
#       #           #   #
#        #           #  #
#        # #        #   #
#       # #      ###    #
#      #        #       #
# ##  #         #      ##
######           ########
#  #                  # #
#  #  #                 #
#  ###        ##        #
#     #        ###     ##
#              #####  ###
#              ##########
#########################
