#########################
############ ############
###########   ###########
##########     ##########
#########       #########
########         ########
#######           #######
######             ######
#####               #####
####                 ####
###                   ###
##                     ##
#                       #
##                     ##
###                   ###
####                 ####
#####               #####
######             ######
#######           #######
########         ########
#########       #########
##########     ##########
###########   ###########
############ ############
#########################
