#########################
#  ####                 #
#   ##                  #
#   ##                  #
#   ##      ###         #
#   ##      ###         #
#   ##      #############
#   ##       ############
#                       #
#                       #
#                       #
#                       #
#              #        #
###            #        #
###            #        #
#####          #        #
#####          ####     #
###            #        #
###            #        #
#              #        #
#              #        #
#              #        #
#              #        #
#              #        #
#########################
