#########################
#                  #   ##
#            ###      # #
##    #  #      ##   #  #
# #      ###      # #   #
# ##      #        #    #
#  ##           #       #
#   #####               #
#       ##              #
#      #  #   #         #
#     #    # # ####   # #
#    #      #          ##
#    # #                #
#     #                 #
# #        #    #       #
# #             #####   #
# #   ###           #   #
##  ##        #######   #
#    #        #         #
#    #        ##     #  #
#     #   #   ###    ## #
#      ###      ###     #
# #               #     #
#                  #    #
#########################
