#########################
#                       #
#                       #
#                  ##   #
#   ##########     ##   #
#   ##########          #
#   ##########          #
#                       #
#                       #
#                       #
#                       #
#                ####   #
#                ####   #
#                ####   #
#     ###         ##    #
#     ###         ##    #
#     ###        ####   #
#                ####   #
#                ####   #
#                       #
#           #           #
#                       #
#                       #
#                       #
#########################
