#########################
#  # #   #   #   #   ## #
## # # # # # # #   #    #
## # ### # # # ######## #
#  #     # # #   #    # #
# ### #### # # # # ##   #
#          # # # # ######
############ ### #  #   #
#  #   #   #   # ## # ###
## # #   # # ###  # #   #
## # ##### # # # ## # # #
## #     #   #    # ### #
## ##### ## ##### #     #
#      # ##     # ### # #
# ###### #  ### #   # # #
#        # ## # ### # # #
########## #  #   # # # #
#    #   ### #### # # # #
# ## # #        # # ### #
#  # # ##### ## # # # # #
# ## # # #   #  #   #   #
# #  # #   ### ####### ##
# #### # #   # #     # ##
#      # ### #   ###   ##
#########################
